#task:neighbor
East of(-)Eden	Hamlet	no
Oliver Twist(-)	Little Dorrit(-)	no
Love in the Time(-)of Cholera	Home and(-)Exile	no
The Iliad(-)	The Histories(-)	yes
Sophocles II: Ajax, The Women of(-)Trachis, Electra & Philoctetes	Gilgamesh: A New Rendering(-)in English Verse	no
The Brief Wondrous Life(-)of Oscar Wao	Bridge of Sighs: A(-)Novel	yes
The Crucible(-)	The Odyssey(-)	no
Macbeth	Henry IV, Part(-)1	yes
Heart of(-)Darkness	A Passage(-)to India	yes
Their Eyes Were(-)Watching God	Narrative of the Life(-)of Frederick Douglass	yes
Heart of(-)Darkness	Jane Eyre(-)	yes
Demons	Howards End(-)	no
Notes from(-)Underground	Fyodor Dostoevsky's Crime and(-)Punishment	yes
The Annals of Imperial(-)Rome	The Jugurthine War / The(-)Conspiracy of Catiline	no
The Eternal Husband and(-)Other Stories	The Landmark Herodotus:(-)The Histories	no
The Catcher in(-)the Rye	Their Eyes Were(-)Watching God	no
The Stranger	Siddhartha	yes
To Kill(-)a Mockingbird	Things Fall Apart:(-)A Novel	no
Achebe's Things Fall Apart:(-)A Reader's Guide	The Perennial(-)Philosophy	no
The Satanic Verses:(-)A Novel	Infidel	yes
Phenomenology of(-)Spirit	The Marx-Engels(-)Reader:	yes
Plato: Republic	Kant: Groundwork of the(-)Metaphysics of Morals	yes
The Hour I First(-)Believed: A Novel	Man Gone Down:(-)A Novel	no
The Stranger	One Day in the Life(-)of Ivan Denisovich	yes
Brave New(-)World	Slaughterhouse-Five: A(-)Novel	yes
Golding's the Lord of(-)the Flies	Demian	no
Paradise Lost(-)	Utopia	yes
The Great(-)Gatsby	Tar Baby	no
2666: A(-)Novel	How Fiction(-)Works	yes
The White Tiger: A(-)Novel	The Guernsey Literary and Potato(-)Peel Pie Society	yes
Twilight: The Complete Illustrated(-)Movie Companion	Twilight: The(-)Score	yes
The Last(-)American Man	Little Heathens: Hard Times and High Spirits on(-)an Iowa Farm During the Great Depression	no
On Chesil(-)Beach	Bridge of Sighs: A(-)Novel	yes
Anna Karenina(-)	Love in the Time(-)of Cholera	yes
To the(-)Lighthouse	Howards End(-)	yes
2666: A(-)Novel	The Hour I First(-)Believed: A Novel	no
Heart of(-)Darkness	The Awakening	yes
Chronicle of a(-)Death Foretold	The English(-)Patient	no
The Stranger	Existentialism And Human(-)Emotions	yes
The Ethics(-)Of Ambiguity	To the(-)Lighthouse	no
Heart of(-)Darkness	All Quiet on the(-)Western Front	no
The Book(-)Thief	On Beauty	no
Catch-22	Huxley's Brave New(-)World	no
Lord of the(-)Flies	Animal Farm(-)and 1984	yes
The History of the Peloponnesian(-)War: Revised Edition	The Cambridge Companion to(-)Dante	no
The Stranger	Rosencrantz and Guildenstern(-)Are Dead	yes
Julius Caesar(-)	Brave New World and(-)Brave New World Revisited	no
The Great(-)Gatsby	The Old Man and(-)The Sea	yes
#task:path_three_nodes
A Thousand(-)Splendid Suns	On Chesil(-)Beach	The Pillars of the(-)Earth	no
The Epic of(-)Gilgamesh	The Daodejing(-)of Laozi	Introductory Lectures(-)on Psychoanalysis	yes
A Hero of Our(-)Time	Notes from(-)Underground	All Quiet on the(-)Western Front	no
Huxley's Brave New(-)World	Animal Farm	Fahrenheit 451	yes
White Teeth:(-)A Novel	The God of Small(-)Things: A Novel	The Brief Wondrous Life(-)of Oscar Wao	yes
Utopia	The Divine(-)Comedy	Divine Comedy:(-)Inferno	no
The Rebel: An Essay(-)on Man in Revolt	The Stranger	Things Fall Apart:(-)A Novel	yes
Civilization and(-)Its Discontents	The Communist(-)Manifesto	The Wealth of(-)Nations	yes
Love in the Time(-)of Cholera	Middlesex: A(-)Novel	The Glass Castle:(-)A Memoir	yes
We Never Make Mistakes:(-)Two Short Novels	The Gulag Archipelago Volume 1: An(-)Experiment in Literary Investigation	Gulag: A(-)History	yes
City of(-)God	The Aeneid of(-)Virgil	Metamorphoses	no
Crime and(-)Punishment	Fyodor Dostoevsky's Crime and(-)Punishment	Spark Notes Crime(-)and Punishment	yes
The Real George(-)Washington	The Real Benjamin(-)Franklin	Liberty and Tyranny: A(-)Conservative Manifesto	yes
Oblomov	The Collected Tales of(-)Nikolai Gogol	Notes from(-)Underground	no
The Fatal(-)Eggs	White Guard	Red Cavalry	yes
Black Ships Before Troy: The(-)Story of 'The Iliad'	D'Aulaires' Book of(-)Norse Myths	Leif the(-)Lucky	yes
A Streetcar(-)Named Desire	The Wayward(-)Bus	The Pastures of(-)Heaven	no